   WE                            main.c
NO      main.c



SO main.c

F      17,38,64

EA main.c



C 218,234,235

                                1
                          111111011111       
                          1     1            
1111111111111111111111111       1
10S0110000100000000000001
1000110000000000111111001
1000110000000000110001001
1000000000100000000001001
1111111111111111111111111
                           1